9.xN
..x..........x.....xx....x.
....x......................
............x..............
...........................
....x......................
...............x...........
...........................
......x..............x.....
..x.......x................
